############
#        O #
#  X    ####
#          #
#######    #
#  O ##    #
#    ##    #
#          #
#     P X  #
#       #  #
############
