 ##############
  #    P        ##
  # X   X  ###  #
  # #####    #X #
  # #   # X  #  #
  # #   ### ##  #
### #   ##  ##X##
#OO ## ##   ##  #
#OO  # #    ##  #
#OO  # #   ###X #
#OO  # ##       #
###### ##  X    #
        # X  # ##
        ###    #
          ######